spacing=5
00000000000000000
01111111111111110
01111111111111110
01110111011101110
01010101010101010
01110111011101110
01111111111111110
01111111111111110
01110111011101110
01010101010101010
01110111011101110
01111111111111110
01111111111111110