spacing=5
00000000000000000
00000000000000000
00111100000111100
00111100000111100
00111100000111100
00111100000111100
00111100000111100
00000011111000000
00000011111000000
00000011111000000
00000011111000000