spacing=5
00000000000000000
00111111111111100
00011111111110000
00001111111100000
00000111111000000
00000011110000000
00000011110000000
00000011110000000
00000111111000000
00001111111110000
00011111111110000